11111111111111111111
10000000000000000001
11111100011000111111
10000100011000100001
10110101011010101101
10010101011010101001
10010101000010101001
10010001111110001001
10000000011000000001
10111110011001111101
10000000000000000001
10001010100101010001
10101000100100010101
10101110111101110101
10100000000000000101
10110001100110001101
10000100100100100001
10111110111101111101
10000000000000000001
11111111111111111111